10 10
GGGGGGGWWW
GGGGGGGGWW
GGRFFFFFGG
RRRFFFFFFF
RFFFFFFFGG
GGGFFFFFFG
GGWGGGGGGG
GWWWGGGGGG
GWWWGGGGGG
GGWGGGGGGG